11111
110C1
11111
11EP1
11111
11111